T: 1 textures/TECH_2F.raw
T: 2 textures/TECH_3B.raw
T: 3 textures/TECH_4F.raw
T: 4 textures/TECH_4E.raw
T: A textures/CRATE_2C.raw
T: B textures/CRATE_1E.raw
T: C textures/CRATE_1D.raw
T: d textures/DOOR_1A.raw
T: c textures/Coin
00000000000000000000000000000000
00000000000000000000000000000000
00000000000000000000000000000000
00000000000000000000000000000000
00000000000000000000000000000000
00000000000000000000000000000000
00000000000000000000000000000000
00000000000000000000000000000000
00000000000000000000000000000000
00000000000000000000000000000000
00000000000000000000000000000000
00000000000000000000000000000000
00000000000000000000000000000000
00000000000000000000000000000000
11100000000000000000000000000000
1p100000000000000000000000000000
1c100000000000000000000000000000
1c100000000000000000000000000000
1c100000000000000000000000000000
1c100000000000000000000000000000
1c100000000000000000000000000000
1c100000000000000000000000000000
1c100000000000000000000000000000
1c100000000000000000000000000000
1c100000000000000000000000000000
1c100000000000000000000000000000
1c100000000000000000000000000000
1c100000000000000000000000000000
1c100000000000000000000000000000
1c100000000000000000000000000000
1c100000000000000000000000000000
11100000000000000000000000000000