T: 1 textures/TECH_2F.raw
T: 2 textures/TECH_3B.raw
T: 3 textures/TECH_4F.raw
T: 4 textures/TECH_4E.raw
T: A textures/CRATE_2C.raw
T: B textures/CRATE_1E.raw
T: C textures/CRATE_1D.raw
T: d textures/DOOR_1A.raw

11111111234111111111111111111111
1A000000000000000000000000000001
1111111d11111111d111111111111111
10000000000001000000000000000001
10111111111001000111110001111001
10100000001001000100000001000001
10100B0000100100C110000011B00001
10100000001001000100000001000002
10111111d11001000111110001111002
10000000000001000000000000000001
111111111111d1111111121131111111
10000000000000000000000000000001
11111d1111011111111111011111d111
10000000010100000000010100000001
10000A00010d00p000000d0100B00001
10000000010100000000010100000001
1111111111d1211d1211131111d11111
10000000000000000000000000000001
10000000000A00000000000000000001
10100001000100000001000001000101
10100C10001000A00000100000100101
10100001000100000001000001000101
11111111d11111231311111111111111
10000000000000000000000000000001
10000000000000000000000000000001
10000000000000000000000000000001
10000000000000000000000000000001
1010000B00000A000000000000001001
1010000000000000000000000C000101
10000000000000000000000000000001
10000000000000000000000000000001
11111111111111111111111111111111