1111111111111111
1000001000000001
1000000100000001
1000000001000001
1000000000010001
1000000000000001
10000P0000010001
1000000000000001
1111111111111111