111111111111
100000000001
100000000001
100000000001
100000000001
100000000001
100000000001
100000000001
10000P000001
100101010001
100001000001
111111111111