11111111
10000001
10001001
10000001
10010001
101P0001
10010001
11111111