11121111
10000001
10000001
20000002
10000001
100P0001
10010001
11122211