11111111
10001001
10001101
10000001
10010001
101P1001
10000001
11111111