T: 1 textures/TECH_2F.raw
T: 2 textures/TECH_3B.raw
T: 3 textures/TECH_4F.raw
T: 4 textures/TECH_4E.raw
T: A textures/CRATE_2C.raw
T: B textures/CRATE_1E.raw
T: C textures/CRATE_1D.raw
T: d textures/DOOR_1A.raw
T: c textures/Coin
11111111111111111111111111111111
1000000000000000p000000000000001
10000000000000000000000000000001
10000000000000000000000000000001
10000000000000000000000000000001
10000000000000000000000000000001
10000000000000000000000000000001
10000000000000000000000000000001
10000000000000000000000000000001
10000000000000000000000000000001
10000000000000000000000000000001
10000000000000000000000000000001
10cccccccccccccccccccccccccccc01
10000000000010000000000000000001
10000000000000000000000000000001
10000000000000000000000000000001
10000000000000000000000000000001
10000000000000010000000000000001
10000000000001000000000000000001
10000000000000000100000000000001
10000000000010000000000000000001
10000000000000000000000000000001
10000000000000000000000000000001
10000010000000000000000000000001
10000000000000000000010000000001
10000000000000000000000000000001
10000000000000000000000000000001
10000000000000000000000000000001
10000010000000000000000000000001
10000000000000000000000000100001
10000000000000000000000000000001
11111111111111111111111111111111