T: 1 textures/Brick_Wall.raw
T: 2 textures/Floor.raw
11111111111111111111111111111111
10000000000000000000000000000001
10000000000000000000000000000001
10000000000000000000000000000001
10000000000000000000000000000001
10000000000000000000000000000001
10000000000000000000000000000001
10000000000000000000000000000001
10000000000000000000000000000001
10000000000000000000000000000001
10000000000000000000000000000001
10000000000000000000000000000001
10000000000000000000000000000001
10000000000000000000000000000001
10000000000000000000000000000001
10000000000000000000000000000001
10000000000000000000000000000001
10000000000000000000000000000001
10000000000000000000000000000001
10000000000000000000000000000001
10000000000000000000000000000001
10000000000000000000000000000001
10000000000000000000000000000001
10000010000000000000000000000001
10000000000000000000010000000001
10000000000000000000000000000001
10000000000000000000000000000001
10000000000000000000000000000001
10000010000000000000000000000001
10000000000000000000000000100001
100000000000000000000000000000P1
11111111111111111111111111111111