11111111111111
10000000000001
10000000111111
100000001
100000001
100000001
1000P0001
10000000111111
10000000000001
11111111111111